###########
#.....#...#
###...#...#
##...P....#
#...#.....#
#..##..##.#
#......##.#
#.........#
###########