############....####
#.....#....#....#..#
###...#...#######..#
##...P..........#..#
#...#........####..#
#..##..##.#....#...#
#......##.#...##...#
#.........#........#
###########..##...##
..........#.......#
..........#########