############################################
#.P........................................#
#...#####........##########........#####...#
#...#............#........#............#...#
#...#..................................#...#
#.........#......................#.........#
#...#.....#....#####....#####....#.....#...#
#...#.....#....#............#....#.....#...#
#...#.....#....#............#....#.....#...#
#...#.....#......................#.....#...#
#...#.....#......................#.....#...#
#...#.....#....#............#....#.....#...#
#...#.....#....#............#....#.....#...#
#...#.....#....#####....#####....#.....#...#
#.........#......................#.........#
#...#..................................#...#
#...#............#........#............#...#
#...#####........##########........#####...#
#..........................................#
############################################